newts	newt
orangutans	orangutan
peacocks	peacock
quails	quail
ravens	raven
salamanders	salamander
tyrannosauruses	tyrannosaurus
unicorns	unicorn
vultures	vulture
walruses	walrus
xylophones	xylophone
yaks	yak
zebras	zebra

giggles	giggle
smiles	smile
sleeps	sleep
swims	swim
waits	wait
moves	move
changes	change
reads	read
eats	eat

entertains	entertain
amuses	amuse
high_fives	high_five
applauds	applaud
confuses	confuse
admires	admire
accepts	accept
remembers	remember
comforts	comfort