newt	newts
orangutan	orangutans
peacock	peacocks
quail	quails
raven	ravens
salamander	salamanders
tyrannosaurus	tyrannosauruses
unicorn	unicorns
vulture	vultures
walrus	walruses
xylophone	xylophones
yak	yaks
zebra	zebras
giggle	giggles
smile	smiles
sleep	sleeps
swim	swims
wait	waits
move	moves
change	changes
read	reads
eat	eats
entertain	entertains
amuse	amuses
high_five	high_fives
applaud	applauds
confuse	confuses
admire	admires
accept	accepts
remember	remembers
comfort	comforts